TILEMAP
32 24 							-- Size of tile map in tiles
8 8 							-- Tile size & block size
images/tiles_red.png 	-- Tilesheet
16 16 								-- Number of tiles in tilesheet
0 0 0 0 0 0 0 0 0 0 0 0 0 0 0 0 0 0 0 0 0 0 0 0 0 0 0 0 0 0 0 0
0 0 0 0 0 0 0 0 0 0 0 0 0 0 0 0 0 0 0 0 0 0 0 0 0 0 0 0 0 0 0 0
86 15 14 68 86 15 14 66 111 112 111 112 111 112 111 112 111 112 111 112 111 112 111 112 111 112 111 112 111 112 111 112
0 0 0 0 0 0 0 159 112 111 112 111 112 111 112 111 112 111 112 111 112 111 112 111 112 111 112 111 112 111 112 111
0 0 0 0 0 0 0 160 111 112 111 112 111 112 111 112 111 112 111 112 111 112 111 112 111 112 111 112 111 112 111 112
0 0 0 0 0 0 0 159 112 111 112 111 112 111 112 111 112 111 112 111 112 111 112 111 112 111 112 111 112 111 112 111
0 0 0 0 0 0 0 0 86 14 15 68 86 14 15 68 86 15 14 68 86 15 14 68 86 15 14 68 86 15 14 66
0 0 0 0 0 0 0 0 0 0 0 0 0 0 0 0 0 0 0 0 0 70 104 88 0 0 0 -3 0 0 0 159
0 0 0 0 0 0 0 0 0 0 -9 193 194 195 0 0 0 0 0 0 -5 71 105 89 0 0 0 0 0 0 0 160
0 0 0 0 0 73 106 91 0 0 0 209 210 211 0 0 0 0 0 0 0 0 0 0 0 0 0 0 0 0 0 159
0 0 0 0 0 72 0 90 0 0 0 225 0 227 0 0 0 0 0 0 0 0 0 0 0 0 0 0 0 0 0 0
1 1 1 1 1 157 1 175 1 1 1 22 1 24 1 176 0 0 0 0 0 73 106 91 0 0 0 0 0 0 0 0
86 14 15 68 86 14 15 68 86 15 14 68 86 15 14 68 0 0 0 0 0 72 -10 90 0 0 -14 0 0 0 0 0
0 0 0 0 0 0 0 0 0 0 0 0 0 0 0 0 158 1 1 1 1 157 1 175 1 1 1 1 1 1 1 1
0 0 0 0 0 0 0 0 0 0 0 0 0 0 0 0 86 14 15 68 86 14 15 68 86 15 14 68 86 15 14 66
0 0 0 0 0 0 0 0 0 0 0 0 0 0 0 0 0 0 0 0 0 0 0 0 0 0 0 0 0 0 0 159
0 0 0 0 0 0 0 0 0 0 0 0 0 0 0 0 0 0 0 0 0 0 0 0 0 0 0 0 0 0 0 160
0 0 0 0 0 0 0 0 0 0 0 0 0 0 0 0 0 0 0 0 0 0 0 0 0 0 0 0 0 0 0 159
31 32 31 32 31 32 31 32 31 32 31 32 31 32 31 32 31 32 31 32 31 32 31 32 31 32 31 32 31 32 31 32
32 31 32 31 32 31 32 31 32 31 32 31 32 31 32 31 32 31 32 31 32 31 32 31 32 31 32 31 32 31 32 31
31 32 31 32 31 32 31 32 31 32 31 32 31 32 31 32 31 32 31 32 31 32 31 32 31 32 31 32 31 32 31 32
32 31 32 31 32 31 32 31 32 31 32 31 32 31 32 31 32 31 32 31 32 31 32 31 32 31 32 31 32 31 32 31
0 0 0 0 0 0 0 0 0 0 0 0 0 0 0 0 0 0 0 0 0 0 0 0 0 0 0 0 0 0 0 0
0 0 0 0 0 0 0 0 0 0 0 0 0 0 0 0 0 0 0 0 0 0 0 0 0 0 0 0 0 0 0 0
