TILEMAP
32 24 							-- Size of tile map in tiles
8 8 							-- Tile size & block size
images/tiles_red.png 	-- Tilesheet
16 16 								-- Number of tiles in tilesheet
0 0 0 0 0 0 0 0 0 0 0 0 0 0 0 0 0 0 0 0 0 0 0 0 0 0 0 0 0 0 0 0
0 0 0 0 0 0 0 0 0 0 0 0 0 0 0 0 0 0 0 0 0 0 0 0 0 0 0 0 0 0 0 0
111 112 111 112 111 112 111 112 111 112 111 112 111 112 111 112 111 112 111 112 111 112 111 112 111 112 111 112 111 112 111 112
112 111 112 111 112 111 112 111 112 111 112 111 112 111 112 111 112 111 112 111 112 111 112 111 112 111 112 111 112 111 112 111
111 112 111 112 111 112 111 112 111 112 111 112 111 112 111 112 111 112 111 112 111 112 111 112 111 112 111 112 111 112 111 112
112 111 112 111 112 111 112 111 112 111 112 111 112 111 112 111 112 111 112 111 112 111 112 111 112 111 112 111 112 111 112 111
84 14 15 68 86 14 15 68 86 14 15 68 86 14 15 68 86 14 15 68 86 14 15 68 86 15 14 68 86 15 14 66
81 0 0 -3 0 0 0 0 0 0 0 0 0 0 0 102 103 0 0 0 0 0 0 -3 0 0 -4 0 0 0 0 159
82 0 0 0 0 0 0 0 0 0 0 0 0 0 0 0 0 0 163 35 181 0 0 0 0 0 0 0 0 0 0 160
81 0 0 0 0 0 0 0 0 0 0 0 0 0 0 0 0 0 162 34 180 0 0 0 0 0 0 0 0 0 0 159
-523011 0 0 0 0 0 0 0 0 0 0 0 0 0 0 0 0 0 161 -320407 179 0 0 0 0 0 0 0 0 0 0 159
-523011 0 0 0 0 0 0 0 0 0 0 158 1 1 1 1 1 1 74 1 92 1 1 1 1 1 1 1 176 0 0 160
-523011 0 0 0 0 0 0 0 0 0 0 14 13 100 15 68 86 14 15 68 86 14 15 68 86 15 100 13 14 0 0 65
1 1 1 1 1 1 1 176 0 0 0 0 0 101 0 102 103 0 -4 -3 0 0 0 102 103 0 101 0 0 0 0 159
84 14 15 68 86 14 15 68 0 0 0 0 0 101 0 0 0 0 0 0 0 0 0 0 0 0 101 0 0 0 0 159
81 0 0 0 0 0 0 0 0 0 0 0 0 101 0 0 0 0 0 0 0 0 0 0 0 0 101 0 0 0 0 160
82 0 0 0 0 0 0 0 0 0 0 0 0 101 0 -2 0 0 0 0 0 0 0 0 0 0 101 0 0 0 0 159
85 1 1 1 1 1 1 1 1 1 1 1 1 2 1 1 1 1 1 1 1 1 1 1 1 1 2 1 1 1 1 67
84 14 15 68 86 14 15 68 86 15 14 68 86 15 14 66 84 14 15 68 86 14 15 68 86 15 14 68 86 15 14 66
81 0 0 0 0 0 0 0 0 0 0 0 0 0 0 159 81 0 0 0 0 0 0 0 0 0 0 0 0 0 0 159
82 0 0 0 0 0 0 0 0 0 0 0 0 0 0 160 82 0 0 0 0 0 0 0 0 0 0 0 0 0 0 160
81 0 0 0 0 0 0 0 0 0 0 0 0 0 0 159 81 0 0 0 0 0 0 0 0 0 0 0 0 0 0 159
0 0 0 0 0 0 0 0 0 0 0 0 0 0 0 0 0 0 0 0 0 0 0 0 0 0 0 0 0 0 0 0
0 0 0 0 0 0 0 0 0 0 0 0 0 0 0 0 0 0 0 0 0 0 0 0 0 0 0 0 0 0 0 0
