TILEMAP
32 24 							-- Size of tile map in tiles
8 8 							-- Tile size & block size
images/tiles_red.png 	-- Tilesheet
16 16 								-- Number of tiles in tilesheet
0 0 0 0 0 0 0 0 0 0 0 0 0 0 0 0 0 0 0 0 0 0 0 0 0 0 0 0 0 0 0 0
0 0 0 0 0 0 0 0 0 0 0 0 0 0 0 0 0 0 0 0 0 0 0 0 0 0 0 0 0 0 0 0
81 0 0 0 0 0 0 0 0 0 0 0 0 0 0 0 86 14 15 68 86 14 15 68 86 14 15 68 86 14 15 68
81 0 0 0 0 0 0 0 73 106 91 0 0 0 0 0 70 104 88 0 0 0 0 0 0 0 0 0 0 0 0 0
82 0 0 0 0 0 0 0 72 -10 90 0 0 -16 0 -5 71 105 89 0 0 0 0 0 0 0 0 0 0 0 0 0
85 1 1 1 1 1 1 1 157 1 175 1 1 1 1 176 0 0 0 0 0 0 0 0 0 0 0 0 0 0 0 0
84 14 100 68 86 14 15 68 86 14 15 68 86 14 15 68 0 0 0 0 0 0 0 0 0 0 0 0 0 0 0 0
81 0 101 0 0 0 0 0 0 0 -4 0 0 0 0 0 0 0 0 0 0 70 104 88 0 0 0 0 0 0 0 0
82 0 101 0 0 0 163 35 181 0 0 0 0 0 0 0 0 0 0 0 -5 71 105 89 0 0 0 0 0 0 0 0
81 0 101 0 0 0 162 34 180 0 0 0 0 0 0 0 0 0 0 0 0 0 0 0 0 0 0 0 0 0 0 0
81 0 101 0 0 0 161 0 179 0 0 0 0 0 0 0 0 0 0 0 0 0 0 0 0 0 0 0 0 0 0 0
85 1 2 1 1 1 74 1 92 1 1 176 3 4 4 4 4 4 4 4 4 4 4 4 4 4 4 3 158 1 1 1
84 14 15 68 86 14 15 68 86 14 15 13 16 97 97 97 97 97 97 97 97 97 97 97 97 97 97 16 13 15 14 68
81 0 0 0 0 0 0 0 0 0 0 0 0 0 0 0 0 0 0 0 0 0 0 0 0 0 0 0 0 0 0 0
81 0 0 0 0 0 0 0 0 0 0 0 0 0 0 0 0 0 0 0 0 0 0 0 0 0 0 0 0 0 0 0
82 0 0 0 0 0 0 0 0 0 0 0 0 0 0 0 0 0 0 0 0 0 0 0 0 0 0 0 0 0 0 0
81 0 0 0 0 0 0 0 0 0 0 0 0 0 0 0 0 0 0 0 0 0 0 0 0 0 0 0 0 0 0 0
81 0 0 0 0 0 0 0 0 0 0 0 0 0 0 0 0 0 0 0 0 0 0 0 0 0 0 0 0 0 0 0
31 32 31 32 31 32 31 32 31 32 31 32 31 32 31 32 31 32 31 32 31 32 31 32 31 32 31 32 31 32 31 32
32 31 32 31 32 31 32 31 32 31 32 31 32 31 32 31 32 31 32 31 32 31 32 31 32 31 32 31 32 31 32 31
31 32 31 32 31 32 31 32 31 32 31 32 31 32 31 32 31 32 31 32 31 32 31 32 31 32 31 32 31 32 31 32
32 31 32 31 32 31 32 31 32 31 32 31 32 31 32 31 32 31 32 31 32 31 32 31 32 31 32 31 32 31 32 31
0 0 0 0 0 0 0 0 0 0 0 0 0 0 0 0 0 0 0 0 0 0 0 0 0 0 0 0 0 0 0 0
0 0 0 0 0 0 0 0 0 0 0 0 0 0 0 0 0 0 0 0 0 0 0 0 0 0 0 0 0 0 0 0
