TILEMAP
32 20 							-- Size of tile map in tiles
8 8 							-- Tile size & block size
images/tiles.png 	-- Tilesheet
16 16 								-- Number of tiles in tilesheet
86 15 14 68 86 15 14 68 86 14 15 68 86 14 15 68 86 14 15 68 86 14 15 68 86 15 14 68 86 15 14 66
-123103 0 0 0 0 0 0 0 0 0 0 0 0 0 0 0 0 0 0 102 103 0 0 0 0 0 0 0 0 0 0 159
-123103 0 0 0 0 0 0 0 0 0 0 0 0 163 35 181 0 0 0 0 0 0 0 0 163 35 181 0 0 0 0 160
-123103 0 0 0 0 0 0 0 0 0 0 0 0 162 34 180 0 0 0 0 0 0 0 0 162 34 180 0 0 0 0 159
-123103 0 0 0 0 0 0 0 0 0 0 0 0 161 0 179 0 -1 0 0 0 0 0 0 161 0 179 0 0 0 0 159
1 1 1 1 1 1 1 176 0 0 0 158 1 74 1 92 1 1 1 1 1 1 1 1 74 1 92 1 176 0 0 160
86 15 100 68 86 15 14 68 0 0 0 14 13 14 15 68 86 14 100 68 86 14 15 68 86 15 14 13 14 0 0 65
-123107 0 101 0 0 0 0 0 0 0 0 0 0 0 0 0 0 0 101 0 0 0 -4 0 0 0 0 0 0 0 0 159
-123107 0 101 0 0 0 0 0 0 0 0 0 0 0 0 0 0 0 101 0 0 0 0 0 0 0 0 0 193 194 195 159
1 1 2 1 1 1 1 176 0 0 0 0 0 0 0 0 0 0 101 0 0 0 0 0 0 0 0 0 209 210 211 159
84 15 14 68 86 100 14 68 0 0 0 0 0 0 0 0 0 0 101 -1 0 0 0 0 0 0 0 0 225 0 227 160
81 0 0 0 0 101 0 0 0 0 0 0 0 0 0 0 158 1 2 1 1 1 1 1 1 1 1 1 22 0 24 67
81 0 0 0 0 101 0 0 0 0 0 0 0 0 0 0 86 15 14 68 86 100 14 66 111 112 111 112 111 112 111 112
81 0 0 0 0 101 0 0 73 106 91 0 0 0 0 0 0 0 0 -3 0 101 0 159 112 111 112 111 112 111 112 111
82 0 0 0 0 101 0 0 72 0 90 -1 0 0 0 0 0 0 0 0 0 101 0 160 111 112 111 112 111 112 111 112
85 1 1 1 1 2 1 1 157 1 175 1 1 1 1 176 0 0 0 0 0 101 0 159 112 111 112 111 112 111 112 111
84 14 15 68 86 14 15 68 86 15 14 68 86 100 14 68 0 0 0 0 0 101 0 159 111 112 111 112 111 112 111 112
81 0 0 0 0 0 0 0 0 0 0 0 0 101 0 0 0 0 0 0 0 101 0 160 112 111 112 111 112 111 112 111
82 0 0 0 0 0 0 0 0 0 0 0 0 101 0 0 0 0 0 0 0 101 0 159 111 112 111 112 111 112 111 112
85 1 1 1 1 1 1 1 1 1 1 1 1 2 1 1 1 1 1 1 1 2 1 67 112 111 112 111 112 111 112 111