TILEMAP
32 24 							-- Size of tile map in tiles
8 8 							-- Tile size & block size
images/tiles_red.png 	-- Tilesheet
16 16 								-- Number of tiles in tilesheet
0 0 0 0 0 0 0 0 0 0 0 0 0 0 0 0 0 0 0 0 0 0 0 0 0 0 0 0 0 0 0 0
0 0 0 0 0 0 0 0 0 0 0 0 0 0 0 0 0 0 0 0 0 0 0 0 0 0 0 0 0 0 0 0
111 112 111 112 111 112 111 112 111 112 111 112 111 112 111 112 111 112 111 112 111 112 111 112 111 112 111 112 111 112 111 112
84  14  15  68  86  14  15  68  86  14  15  68  86  14  15  68  86  14  15  68  86  14  15  66  84  14  15  68  86  14  15  68
81  0  0  0  0  0  0  0  0  0 0 0  0  0  0  0  0  0  0 0  0  0  0  0  0  0  0  0  0  0  0  160
82 0 0 0 0 0 0 0 0 0 0 0 0 0 0 0 0 0 0 0 0 0 0 0 0 0 0 0 0 0 0 159
81  0  0  0  0  0  0  0  0  0  0  0  0  0  0  0  0  0  0  0  0  0  0  0  0  0  0  0  0  0  0  159
81  0   0   0   0   0   0   0   0   0   0   0   0   0   0   0  0   0   0   0   0   0   0   0 0  0   0  0   0   0   0   159
82  0   0   0   0   0   158   1   1   1   176   0   -30  0   0   0   0   0   0   0   0   0   0   0 0  0   0   0   0   0   0   160
81  0   0   0   0   0   86   86   14  100 13  0   0   0   0   0   0   0   0   158   1   1   1   176 0  0   0   0   0   0   0   159
81  0   0   0   0   0   0   0   0  101  0  0   0   0   0   0   0   0   0   68   86   100   14   13   0   0   0   0   0   0   0   160
82  0   0   0 0   0   0   0   0 101   0 0   0   0   0   0   0   0   0   0   0 101   0   0   0   0   0   0 0   0   0   159
83  0   0   0  158  1 1  1  1  2  1  1  176  0  0  0  0  0  0 0  0  101   0   0   0   0   158   1  1  1 1  67
81  0   0   0   13   100 14   15 68 86   14   15   13   0   0  0   0   0   0 0   0   101   0   0   0   0   13   100   15   14 13   66
81  0   0  0   0   101 0   0   0   0   0   0   0   0   0   0   0   0   0 0   0   101   0  0 0 0 0   101   0   0 0   159
82  0   -6   0   0   101 0   0   0   0   0  0 0  0   0   0   0   0   0 0   0   101  0   0 0 0 0   101   0   0 0   160
81  0   0   0   0   101 0   0   0   0   0  0 0  0   0   0   0   0   0 0  0   101   0   0 0   0 0   101   0   0 0   159
81  0   0   0   0   101   0   0   0   0   0 0   0 0   0   0  0   0  0   0   0   101   0   0  0   0  0   101   0   0   0   159
85  1   1   1   1   2   1   1   1   1   1 1   1 1   1   1   1   1  1   1   1   2   1   1  1   1  1   2   1   1   1   67
112 111 112 111 112 111 112 111 112 111 112 111 112 111 112 111 112 111 112 111 112 111 112 111 112 111 112 111 112 111 112 111
111 112 111 112 111 112 111 112 111 112 111 112 111 112 111 112 111 112 111 112 111 112 111 112 111 112 111 112 111 112 111 112
112 111 112 111 112 111 112 111 112 111 112 111 112 111 112 111 112 111 112 111 112 111 112 111 112 111 112 111 112 111 112 111
0 0 0 0 0 0 0 0 0 0 0 0 0 0 0 0 0 0 0 0 0 0 0 0 0 0 0 0 0 0 0 0
0 0 0 0 0 0 0 0 0 0 0 0 0 0 0 0 0 0 0 0 0 0 0 0 0 0 0 0 0 0 0 0