TILEMAP
32 24 							-- Size of tile map in tiles
8 8 							-- Tile size & block size
images/tiles_red.png 	-- Tilesheet
16 16 								-- Number of tiles in tilesheet
0 0 0 0 0 0 0 0 0 0 0 0 0 0 0 0 0 0 0 0 0 0 0 0 0 0 0 0 0 0 0 0
0 0 0 0 0 0 0 0 0 0 0 0 0 0 0 0 0 0 0 0 0 0 0 0 0 0 0 0 0 0 0 0
111 112 111 112 111 112 111 112 111 112 111 112 111 112 111 112 111 112 111 112 111 112 111 112 111 112 111 112 111 112 111 112
112 111 112 111 112 111 112 111 112 111 112 111 112 111 112 111 112 111 112 111 112 111 112 111 112 111 112 111 112 111 112 111
111 112 111 112 111 112 111 112 111 112 111 112 111 112 111 112 111 112 111 112 111 112 111 112 111 112 111 112 111 112 111 112
112 111 112 111 112 111 112 111 112 111 112 111 112 111 112 111 112 111 112 111 112 111 112 111 112 111 112 111 112 111 112 111
84  14  15  68  86  14  15  68  86  14  15  68  86  14  15  68  86  14  15  68  86  14  15  66  84  14  15  68  86  14  15  68
81  0   0   0   0   0   0   0   0   0   0   0   0   0   0   -3  0   0   0   0   0   0   0   159 81  0   -4  0   0   0   0   0
82  0   0   0   0   0   0   0   0   0   0   0   -30  0   0   0   0   0   0   0   0   0   0   160 82  0   0   0   0   0   0   0
81  0   0   0   0   0   0   0   73  106 91  0   0   0   0   0   0   0   0   0   0   0   0   159 81  0   0   0   0   0   0   0
81  0   0   0   0   0   0   0   72  0  90  0   0   0   0   0   0   0   0   0   0   0   0   0   0   0   0   0   0   0   0   0
82  0   0   158 1   1   1   1   157 1   175 1   1   1   1   1   1   1   1   1   176 0   0   0   0   0   0   158 1   1   1   1
83  0   0   14  13  100 15  68  86  14  15  68  86  14  15  68  86  15  100 13  14  0   0   0   0   0   0   14  13  100 15  66
81  0   0   0   0   101 0   102 103 0   0   0   0   0   -4  0   0   0   101 0   0   0   0   0   0   0   0   0   0   101 0   160
81  0   -6  0   0   101 0   0   0   0   0   0   0   0   0   0   0   0   101 0   0   0   0  193 194 195 0   0   0   101 0   159
82  0   0   0   0   101 0   0   0   0   73  106 91  0   0   0   0   0   101 0   0   0   0   209 210 211 0   0   0   101 0   160
81  0   0   0   0   101 0   0   0   0   72  0 90  0   0   0   0   0   101 0  0   0   0   225 0   227 0   0   0   101 0   159
85  1   1   1   1   2   1   1   1   1   157 1   175 1   1   1   1   1   2   1   1   1   1   22  1   24  1   1   1   2   1   67
111 112 111 112 111 112 111 112 111 112 111 112 111 112 111 112 111 112 111 112 111 112 111 112 111 112 111 112 111 112 111 112
112 111 112 111 112 111 112 111 112 111 112 111 112 111 112 111 112 111 112 111 112 111 112 111 112 111 112 111 112 111 112 111
111 112 111 112 111 112 111 112 111 112 111 112 111 112 111 112 111 112 111 112 111 112 111 112 111 112 111 112 111 112 111 112
112 111 112 111 112 111 112 111 112 111 112 111 112 111 112 111 112 111 112 111 112 111 112 111 112 111 112 111 112 111 112 111
0 0 0 0 0 0 0 0 0 0 0 0 0 0 0 0 0 0 0 0 0 0 0 0 0 0 0 0 0 0 0 0
0 0 0 0 0 0 0 0 0 0 0 0 0 0 0 0 0 0 0 0 0 0 0 0 0 0 0 0 0 0 0 0