TILEMAP
32 20 							-- Size of tile map in tiles
8 8 							-- Tile size & block size
images/tiles.png 	-- Tilesheet
16 16 								-- Number of tiles in tilesheet
81 0 0 0 0 101 0 0 0 0 0 0 0 0 0 0 0 0 0 0 0 101 0 0 0 0 0 0 0 0 0 159
82 0 0 0 0 101 0 0 0 0 0 0 0 0 0 0 0 0 0 0 0 101 0 0 0 0 0 0 0 0 0 160
81 0 0 0 0 101 0 0 0 0 0 0 0 0 0 0 0 0 0 0 0 101 0 0 0 0 0 0 0 0 0 159
81 0 0 0 0 101 0 0 0 0 0 0 0 0 0 0 0 0 0 0 0 101 0 0 0 0 0 0 0 0 0 159
81 0 0 0 0 101 0 0 0 0 0 0 0 0 0 0 0 0 0 0 0 101 0 0 0 0 0 0 0 0 0 159
82 0 0 0 0 101 0 0 0 0 0 0 0 0 0 0 0 0 0 0 0 101 0 0 0 0 0 0 0 0 0 159
81 0 0 0 0 101 0 0 0 0 0 0 0 0 -1 0 0 0 0 0 0 101 0 0 0 0 0 0 0 0 0 160
81 0 0 0 0 101 0 0 0 0 0 158 1 1 1 1 1 1 1 1 1 2 1 1 1 1 1 1 1 1 1 67
81 0 0 0 0 101 0 0 0 0 0 14 13 100 15 68 86 15 14 68 86 15 14 66 111 112 111 112 111 112 111 112
82 0 0 0 0 101 0 0 0 0 0 0 0 101 0 -3 0 0 0 0 0 0 0 159 112 111 112 111 112 111 112 111
81 0 0 0 0 101 0 0 0 0 0 0 0 101 0 0 0 0 0 0 0 0 0 160 111 112 111 112 111 112 111 112
81 0 0 0 0 101 0 0 0 0 0 0 0 101 0 0 0 0 0 0 0 0 0 159 112 111 112 111 112 111 112 111
81 0 0 0 0 101 0 0 0 0 0 0 0 101 0 0 0 0 0 0 0 0 0 0 86 15 14 68 86 15 14 66
82 0 0 0 0 101 0 0 0 0 0 0 0 101 0 0 0 0 0 0 0 0 0 0 0 0 0 -3 0 0 0 159
81 0 0 0 0 101 0 0 0 0 0 0 0 101 0 0 0 0 0 0 0 193 194 195 0 0 0 0 0 0 0 160
81 0 0 0 0 101 0 0 0 0 0 0 0 101 0 0 0 0 0 0 0 209 210 211 0 0 0 0 0 0 0 159
81 0 0 0 0 101 0 0 0 0 0 0 0 101 -1 0 0 0 0 0 0 225 0 227 0 0 0 0 0 0 0 159
82 0 0 0 0 101 0 0 0 0 0 158 1 2 1 1 1 1 1 1 1 22 1 24 1 1 1 1 1 1 1 67
81 0 0 0 0 101 0 0 0 0 0 14 13 14 15 68 86 14 100 68 86 14 15 68 86 15 14 68 86 15 14 66
81 0 0 0 0 101 0 0 0 0 0 0 0 0 0 0 0 0 101 0 0 0 0 0 0 0 0 0 0 0 0 159
