TILEMAP
32 24 							-- Size of tile map in tiles
8 8 							-- Tile size & block size
images/tiles.png 	-- Tilesheet
16 16 								-- Number of tiles in tilesheet
0 0 0 0 0 0 0 0 0 0 0 0 0 0 0 0 0 0 0 0 0 0 0 0 0 0 0 0 0 0 0 0
0 0 0 0 0 0 0 0 0 0 0 0 0 0 0 0 0 0 0 0 0 0 0 0 0 0 0 0 0 0 0 0
84 14 15 68 86 14 15 68 86 14 15 68 86 14 15 68 86 15 14 68 86 15 14 68 86 15 14 68 86 15 14 66
81 0 0 0 0 0 0 0 0 0 0 0 0 0 0 0 0 0 0 0 0 0 0 0 0 0 0 0 0 0 0 159
82 0 0 0 0 0 0 0 0 0 0 0 0 0 0 0 0 0 0 0 0 0 0 0 0 0 0 0 0 0 0 160
81 0 0 0 0 0 0 0 158 1 1 1 1 1 1 1 1 1 1 1 1 1 1 176 0 0 0 0 0 0 0 159
81 0 0 0 0 0 0 0 86 15 100 68 86 15 14 68 86 14 15 68 86 14 15 68 0 0 0 0 0 0 0 159
82 0 0 0 0 0 0 0 0 0 101 0 0 0 0 0 0 0 0 0 0 0 0 0 0 0 0 0 0 0 0 160
81 0 0 193 194 195 0 0 0 0 101 0 0 0 0 0 0 0 0 0 0 0 0 0 163 35 181 0 0 0 0 159
81 0 0 209 210 211 0 0 0 0 101 0 0 0 0 0 0 0 0 0 0 0 0 0 162 34 180 0 0 0 0 159
81 0 0 225 0 227 0 0 0 0 101 0 0 0 0 0 0 0 0 0 0 0 0 0 161 0 179 0 0 0 0 159
85 1 1 22 1 24 1 1 1 1 2 176 3 4 4 4 4 4 4 3 158 1 1 1 74 1 92 1 1 1 1 67
84 14 15 68 86 100 15 68 86 14 15 13 16 97 97 97 97 97 97 16 13 100 14 68 86 15 14 68 86 15 14 66
82 0 0 0 0 101 0 0 0 0 0 0 0 0 0 0 0 0 0 0 0 101 0 0 0 0 0 0 0 0 0 159
81 0 0 0 0 101 0 0 0 0 0 0 0 0 0 0 0 0 0 0 0 101 0 0 0 0 0 0 0 0 0 159
82 0 0 0 0 101 0 0 0 0 0 0 0 0 0 0 0 0 0 0 0 101 0 0 0 0 0 0 0 0 0 160
81 0 0 0 0 101 0 0 0 0 0 0 0 0 0 0 0 0 0 0 0 101 0 0 0 0 0 0 0 0 0 159
81 0 0 0 0 101 0 0 0 0 0 0 0 0 0 0 0 0 0 0 0 101 0 0 0 0 0 0 0 0 0 159
81 0 0 0 0 101 0 0 0 0 0 0 0 0 0 0 0 0 0 0 0 101 0 0 0 0 0 0 0 0 0 159
82 0 0 0 0 101 0 0 0 0 0 0 0 0 0 0 0 0 0 0 0 101 0 0 0 0 0 0 0 0 0 160
81 0 0 0 0 101 0 0 0 0 0 0 0 0 0 0 0 0 0 0 0 101 0 0 0 0 0 0 0 0 0 159
81 0 0 0 0 101 0 0 0 0 0 0 0 0 0 0 0 0 0 0 0 101 0 0 0 0 0 0 0 0 0 159
0 0 0 0 0 0 0 0 0 0 0 0 0 0 0 0 0 0 0 0 0 0 0 0 0 0 0 0 0 0 0 0
0 0 0 0 0 0 0 0 0 0 0 0 0 0 0 0 0 0 0 0 0 0 0 0 0 0 0 0 0 0 0 0