TILEMAP
32 20 							-- Size of tile map in tiles
8 8 							-- Tile size & block size
images/tiles.png 	-- Tilesheet
16 16 								-- Number of tiles in tilesheet
84 14 15 68 86 14 15 68 86 14 15 68 86 14 15 68 86 14 15 68 86 14 15 68 86 14 15 68 86 14 15 68
81 0 0 0 0 0 0 0 0 0 0 0 0 0 0 0 70 104 88 0 0 0 0 0 0 0 0 0 0 0 0 0
82 0 0 0 0 0 0 0 0 0 0 0 0 0 0 0 71 105 89 0 0 0 0 0 0 0 0 0 0 0 0 0
81 0 0 0 0 0 0 0 0 0 0 0 0 0 0 0 0 0 0 0 0 0 0 0 73 106 91 0 0 0 0 0
0 0 0 0 0 0 0 0 0 0 0 0 0 0 0 0 0 0 0 0 0 0 0 0 72 0 90 0 0 0 0 0
0 0 0 0 0 0 0 0 158 1 1 1 1 1 1 1 1 1 1 1 1 1 1 1 157 1 175 1 1 1 1 1
0 0 0 0 0 0 0 0 86 14 100 68 86 14 15 68 86 14 15 68 86 14 15 68 86 14 15 68 86 14 15 68
0 0 0 0 0 0 0 0 0 0 101 0 0 0 0 0 0 0 0 0 0 0 0 0 0 0 0 0 0 0 0 0
0 0 0 0 0 0 0 0 0 0 101 0 0 0 0 0 0 0 0 0 0 0 0 0 0 0 0 0 0 0 0 0
1 1 1 1 1 1 1 1 1 1 2 176 3 4 4 4 4 4 4 4 4 4 4 4 4 4 4 3 158 1 1 1
84 14 15 68 86 14 15 68 86 14 15 69 16 97 97 97 97 97 97 97 97 97 97 97 97 97 97 16 87 15 14 68
81 0 0 0 0 0 0 0 0 0 0 0 0 0 0 0 0 0 0 0 0 0 0 0 0 0 0 0 0 0 0 0
81 0 0 0 0 0 0 0 0 0 0 0 0 0 0 0 0 0 0 0 0 0 0 0 0 0 0 0 0 0 0 0
82 0 0 0 0 0 0 0 0 0 0 0 0 0 0 0 0 0 0 0 0 0 0 0 0 0 0 0 0 0 0 0
81 0 0 0 0 0 0 0 0 0 0 0 0 0 0 0 0 0 0 0 0 0 0 0 0 0 0 0 0 0 0 0
81 0 0 0 0 0 0 0 0 0 0 0 0 0 0 0 0 0 0 0 0 0 0 0 0 0 0 0 0 0 0 0
31 32 31 32 31 32 31 32 31 32 31 32 31 32 31 32 31 32 31 32 31 32 31 32 31 32 31 32 31 32 31 32
32 31 32 31 32 31 32 31 32 31 32 31 32 31 32 31 32 31 32 31 32 31 32 31 32 31 32 31 32 31 32 31
31 32 31 32 31 32 31 32 31 32 31 32 31 32 31 32 31 32 31 32 31 32 31 32 31 32 31 32 31 32 31 32
32 31 32 31 32 31 32 31 32 31 32 31 32 31 32 31 32 31 32 31 32 31 32 31 32 31 32 31 32 31 32 31