TILEMAP
32 24 							-- Size of tile map in tiles
8 8 							-- Tile size & block size
images/tiles_red.png 	-- Tilesheet
16 16 								-- Number of tiles in tilesheet
0 0 0 0 0 0 0 0 0 0 0 0 0 0 0 0 0 0 0 0 0 0 0 0 0 0 0 0 0 0 0 0
0 0 0 0 0 0 0 0 0 0 0 0 0 0 0 0 0 0 0 0 0 0 0 0 0 0 0 0 0 0 0 0
0 0 0 0 0 38 0 0 0 0 0 0 0 0 0 0 0 0 0 0 0 37 0 0 0 0 0 0 0 0 0 159
0 0 0 0 0 37 0 0 0 0 0 0 0 70 104 88 0 0 0 0 0 37 0 0 0 0 0 0 0 0 0 160
0 0 0 0 0 38 0 0 0 0 0 0 0 71 105 89 0 0 0 0 0 37 0 0 0 0 0 0 0 0 0 159
1 1 1 1 1 6 1 176 0 0 0 0 0 0 0 0 0 0 0 0 0 37 0 0 158 1 1 1 1 1 1 67
86 14 100 68 86 99 15 68 0 0 0 0 0 0 0 0 0 0 0 0 0 37 0 0 86 15 100 68 86 15 14 66
0 0 101 0 0 37 0 0 0 0 0 0 0 73 106 91 0 0 0 0 0 37 0 0 0 0 101 0 0 0 0 159
0 0 101 0 0 37 0 0 0 0 0 0 0 72 -10 90 0 0 0 0 0 38 0 0 0 0 101 0 0 0 0 160
0 0 101 0 0 38 0 0 158 1 1 1 1 157 1 175 1 1 1 1 1 6 1 176 0 0 101 0 0 0 0 159
0 0 101 0 0 37 0 0 86 14 100 68 86 99 36 36 36 36 36 36 36 99 15 68 0 0 101 0 0 0 0 159
0 0 101 0 0 37 0 0 0 0 101 0 0 0 0 0 0 0 0 0 0 0 -4 0 0 0 101 0 0 0 0 160
0 0 101 0 0 38 0 0 0 0 101 0 0 0 0 0 0 0 0 0 0 0 0 0 0 0 101 0 0 0 0 159
1 1 2 1 1 6 1 176 0 0 101 0 0 0 0 0 0 0 0 0 0 0 0 0 158 1 2 1 1 1 1 67
36 36 36 36 36 99 15 68 0 0 101 0 0 0 0 0 0 0 0 0 0 0 0 0 86 15 14 68 86 100 14 66
0 0 0 0 0 0 -4 0 0 0 101 0 0 0 0 0 0 0 0 0 0 0 0 0 0 0 -4 0 0 101 0 159
0 0 0 0 0 0 0 0 0 0 101 0 0 0 0 0 163 35 181 0 0 0 0 0 0 0 0 0 0 101 0 160
0 0 0 0 0 0 0 0 0 0 101 0 0 0 0 0 162 34 180 0 0 0 0 0 0 0 0 0 0 101 0 159
0 0 0 0 0 0 0 0 0 0 101 0 0 0 0 0 161 0 179 0 0 0 -1 0 0 0 0 0 0 101 0 159
1 1 1 1 1 1 1 1 1 1 2 1 1 1 1 1 74 1 92 1 1 1 1 1 1 1 1 1 1 2 1 67
117 118 117 118 117 118 117 118 117 118 117 118 117 118 117 118 117 118 117 118 117 118 117 118 118 117 118 117 118 117 118 117
31 32 31 32 31 32 31 32 31 32 31 32 31 32 31 32 31 32 31 32 31 32 31 32 32 31 32 31 32 31 32 31
0 0 0 0 0 0 0 0 0 0 0 0 0 0 0 0 0 0 0 0 0 0 0 0 0 0 0 0 0 0 0 0
0 0 0 0 0 0 0 0 0 0 0 0 0 0 0 0 0 0 0 0 0 0 0 0 0 0 0 0 0 0 0 0
