TILEMAP
32 24 							-- Size of tile map in tiles
8 8 							-- Tile size & block size
images/tiles_green.png 	-- Tilesheet
16 16 								-- Number of tiles in tilesheet
0 0 0 0 0 0 0 0 0 0 0 0 0 0 0 0 0 0 0 0 0 0 0 0 0 0 0 0 0 0 0 0
0 0 0 0 0 0 0 0 0 0 0 0 0 0 0 0 0 0 0 0 0 0 0 0 0 0 0 0 0 0 0 0
81 0 0 0 0 0 0 0 0 0 0 101 0 0 0 0 0 0 0 0 0 0 0 0 0 0 101 0 0 0 0 159
81 0 0 0 0 0 0 0 0 0 0 101 0 0 0 0 0 0 0 0 0 0 0 0 0 0 101 0 0 0 0 160
82 0 0 0 0 0 0 0 0 0 0 101 0 0 0 0 0 0 0 0 0 0 0 0 0 0 101 0 0 0 0 159
85 1 1 1 1 1 1 1 1 1 1 2 1 1 1 176 0 0 0 0 0 0 0 0 0 0 101 0 0 0 0 159
84 14 15 68 86 14 15 68 86 15 100 68 86 15 14 68 0 0 0 0 0 -1 0 0 0 0 101 0 0 0 0 159
81 0 -4 0 0 0 0 0 0 0 101 0 0 0 0 0 0 0 0 158 1 1 1 1 1 1 2 1 1 1 1 67
82 0 0 0 0 0 0 0 0 0 101 0 0 0 0 0 0 0 0 14 13 100 15 68 86 15 14 68 86 15 14 66
81 0 0 0 0 0 0 0 0 0 101 0 0 0 0 0 0 0 0 0 0 101 0 0 0 0 0 0 0 0 0 159
0 0 0 0 0 0 0 0 0 0 101 0 0 0 0 0 0 0 0 0 0 101 0 0 0 0 0 0 0 0 0 159
0 0 0 73 106 91 0 0 0 0 101 0 0 0 0 0 0 0 0 0 0 101 0 0 0 0 0 0 0 0 0 160
0 0 0 72 0 90 0 0 0 0 101 0 0 0 0 0 0 0 0 0 0 101 0 -22 193 194 195 0 0 0 0 159
1 1 1 157 1 175 1 1 1 1 2 1 1 1 1 176 0 0 0 0 0 101 0 0 209 210 211 0 0 0 0 159
111 112 111 112 111 112 111 112 84 14 15 68 86 100 15 68 0 0 0 0 0 101 0 0 225 0 227 0 0 0 0 159
112 111 112 111 112 111 112 111 81 0 0 0 0 101 0 0 0 0 0 158 1 2 1 1 22 1 24 1 1 1 1 67
111 112 111 112 111 112 111 112 82 0 0 0 0 101 0 0 0 0 0 14 13 14 15 68 86 15 14 68 86 100 14 66
112 111 112 111 112 111 112 111 81 0 0 0 0 101 0 0 0 0 0 0 0 0 0 0 0 0 0 0 0 101 0 159
86 14 15 68 86 14 15 68 0 -21 193 194 195 101 0 0 0 0 0 0 0 0 0 0 0 0 0 0 0 101 0 159
0 0 0 0 0 0 0 0 0 0 209 210 211 101 0 0 0 0 0 73 106 91 0 0 0 0 0 0 0 101 0 160
0 0 0 0 0 0 0 0 0 0 225 -16 227 101 0 -1 0 0 0 72 -13 90 0 0 0 0 0 0 0 101 0 159
1 1 1 1 1 1 1 1 1 1 22 1 24 2 1 1 1 1 1 157 1 175 1 1 1 1 1 1 1 2 1 67
0 0 0 0 0 0 0 0 0 0 0 0 0 0 0 0 0 0 0 0 0 0 0 0 0 0 0 0 0 0 0 0
0 0 0 0 0 0 0 0 0 0 0 0 0 0 0 0 0 0 0 0 0 0 0 0 0 0 0 0 0 0 0 0
