TILEMAP
32 24 							-- Size of tile map in tiles
8 8 							-- Tile size & block size
images/tiles_green.png 	-- Tilesheet
16 16 								-- Number of tiles in tilesheet
0 0 0 0 0 0 0 0 0 0 0 0 0 0 0 0 0 0 0 0 0 0 0 0 0 0 0 0 0 0 0 0
0 0 0 0 0 0 0 0 0 0 0 0 0 0 0 0 0 0 0 0 0 0 0 0 0 0 0 0 0 0 0 0
111 112 111 112 111 112 111 112 84 14 15 68 86 14 15 68 86 15 14 68 86 15 14 66 111 112 111 112 111 112 111 112
112 111 112 111 112 111 112 111 81 0 0 0 0 0 0 0 0 0 0 102 103 0 0 159 112 111 112 111 112 111 112 111
111 112 111 112 111 112 111 112 82 0 -10 0 0 0 0 0 0 0 0 0 0 0 0 160 111 112 111 112 111 112 111 112
112 111 112 111 112 111 112 111 85 1 1 1 1 1 1 176 0 0 0 0 0 0 0 159 112 111 112 111 112 111 112 111
84 14 15 68 86 14 15 68 86 15 14 68 86 100 14 68 0 -9 193 194 195 0 0 159 111 112 111 112 111 112 111 112
81 0 0 0 0 0 0 0 0 0 -4 0 0 101 0 0 0 0 209 210 211 0 0 159 112 111 112 111 112 111 112 111
82 -10 0 -1 0 0 0 0 0 0 0 0 0 101 0 0 0 0 225 0 227 0 0 160 111 112 111 112 111 112 111 112
85 1 1 1 1 1 1 1 1 1 1 1 1 2 1 1 1 1 22 1 24 1 1 67 112 111 112 111 112 111 112 111
111 112 111 112 111 112 111 112 84 14 100 68 86 14 15 68 86 14 15 68 86 14 15 68 86 14 15 68 86 14 15 68
112 111 112 111 112 111 112 111 81 0 101 0 0 0 0 0 0 0 0 0 0 0 0 0 0 0 -4 0 0 0 0 0
111 112 111 112 111 112 111 112 82 0 101 0 0 0 0 0 0 0 0 0 0 0 0 0 0 0 0 0 0 0 0 0
112 111 112 111 112 111 112 111 81 0 101 0 0 0 0 0 158 1 1 1 1 1 1 1 1 1 1 1 1 1 1 1
84 14 15 68 86 14 15 68 0 0 101 0 55 61 145 0 86 15 14 68 86 15 14 66 111 112 111 112 111 112 111 112
81 0 0 0 0 0 0 0 0 0 101 0 56 0 146 0 0 0 0 0 0 0 -4 159 112 111 112 111 112 111 112 111
82 0 0 0 0 0 0 0 0 0 101 0 57 0 147 0 0 0 0 0 0 0 0 160 111 112 111 112 111 112 111 112
85 1 1 1 1 1 1 1 1 1 2 1 151 1 152 176 0 0 0 0 0 0 0 159 112 111 112 111 112 111 112 111
84 15 14 68 86 100 14 68 86 15 14 68 86 100 14 68 0 0 0 0 0 0 0 0 86 14 15 68 86 14 15 68
81 0 0 0 0 101 0 0 0 0 0 0 0 101 0 0 0 0 73 106 91 0 0 0 0 0 0 0 0 0 0 0
82 0 0 0 0 101 0 -1 0 0 0 0 0 101 0 0 0 0 72 0 90 0 0 0 0 0 0 0 0 0 0 0
85 1 1 1 1 2 1 1 1 1 1 1 1 2 1 1 1 1 157 1 175 1 1 1 1 1 1 1 1 1 1 1
0 0 0 0 0 0 0 0 0 0 0 0 0 0 0 0 0 0 0 0 0 0 0 0 0 0 0 0 0 0 0 0
0 0 0 0 0 0 0 0 0 0 0 0 0 0 0 0 0 0 0 0 0 0 0 0 0 0 0 0 0 0 0 0
