TILEMAP
32 24 							-- Size of tile map in tiles
8 8 							-- Tile size & block size
images/tiles_green.png 	-- Tilesheet
16 16 								-- Number of tiles in tilesheet
0 0 0 0 0 0 0 0 0 0 0 0 0 0 0 0 0 0 0 0 0 0 0 0 0 0 0 0 0 0 0 0
0 0 0 0 0 0 0 0 0 0 0 0 0 0 0 0 0 0 0 0 0 0 0 0 0 0 0 0 0 0 0 0
84 14 15 68 86 14 15 68 86 14 15 68 86 14 15 68 86 14 15 68 86 14 15 68 86 15 14 68 86 15 14 66
81 0 0 0 0 0 0 -3 0 0 0 0 0 0 0 0 0 0 -4 0 0 0 0 0 0 0 0 0 0 0 0 159
82 0 0 0 0 0 0 0 0 0 0 0 0 0 0 0 0 0 0 0 0 0 0 162 35 180 0 0 0 0 0 160
81 0 0 0 0 0 0 0 0 0 0 0 0 0 0 0 0 0 0 0 0 0 0 162 34 180 0 0 0 0 0 159
81 0 0 0 0 0 0 0 0 0 0 0 0 0 0 0 0 0 0 0 -10 0 0 161 0 179 0 0 0 0 0 159
82 0 0 0 0 0 0 0 0 0 0 0 0 0 0 0 158 1 1 1 1 1 1 74 1 92 1 1 176 0 0 160
81 0 0 0 0 0 0 0 0 0 0 0 0 0 0 0 86 14 100 68 86 14 15 68 86 15 100 13 14 0 0 65
81 0 0 0 0 0 0 0 0 0 0 0 0 0 0 0 0 0 101 0 0 0 0 0 0 0 101 0 0 0 0 159
81 0 0 0 0 0 0 0 0 0 0 0 0 0 0 0 0 0 101 0 0 0 0 0 0 0 101 0 0 0 0 159
82 0 0 158 1 1 1 1 1 1 1 1 1 1 1 1 1 1 2 1 1 1 1 1 1 1 2 1 176 0 0 160
83 0 0 14 13 100 15 68 86 14 15 68 86 14 15 68 86 14 15 68 86 14 15 68 86 15 14 13 14 0 0 65
81 0 0 0 0 101 0 0 0 0 0 0 0 0 0 0 0 0 0 0 0 0 0 0 0 0 0 0 0 0 0 160
81 0 0 0 0 101 0 0 0 0 0 0 0 0 0 0 0 -1 0 0 0 0 0 0 0 0 0 0 0 0 0 159
82 0 0 0 0 101 0 0 73 107 91 0 0 0 0 0 158 1 1 1 1 1 1 1 1 1 1 1 1 1 1 67
81 -1 0 0 0 101 0 0 72 -10 90 0 0 0 0 0 86 14 15 68 86 14 15 68 86 15 100 68 86 15 14 66
85 1 1 1 1 2 1 1 157 1 175 1 1 1 1 176 0 0 0 0 0 0 0 0 0 0 101 0 0 0 0 160
84 14 15 68 86 14 15 68 86 14 100 68 86 15 14 68 0 0 0 0 0 0 0 0 0 0 101 0 0 0 0 159
81 0 0 0 0 0 0 0 0 0 101 0 0 0 0 0 0 0 0 0 0 0 0 0 0 0 101 0 0 0 0 160
82 0 0 0 0 0 0 0 0 0 101 0 0 0 0 0 0 0 0 0 0 0 0 0 0 0 101 0 0 0 0 159
81 0 0 0 0 0 0 0 0 0 101 0 0 0 0 0 0 0 0 0 0 0 0 0 0 0 101 0 0 0 0 159
0 0 0 0 0 0 0 0 0 0 0 0 0 0 0 0 0 0 0 0 0 0 0 0 0 0 0 0 0 0 0 0
0 0 0 0 0 0 0 0 0 0 0 0 0 0 0 0 0 0 0 0 0 0 0 0 0 0 0 0 0 0 0 0
